NO textures/off/off1.xpm
SO textures/off/off2.xpm
WE textures/off/off3.xpm
EA textures/off/off4.xpm

F 0,0,0
C 0,0,80

        1111111111111111111111111
        1000000000110000000000001
        1011000001110000000000001
        10010000002000000000000N1
111111111011000001110000000000001
100000000011000001112111101111111
11110111111001011100000010001
11112111111001011101010010001
11000000110001011100000010001
10000000000000002000000010001
10000000000000001101010010001
1100000111010101111101111000111
11110111 1110101 101111010001
11111111 1111111 111111111111