NO textures/off/off1.xpm
SO textures/off/off2.xpm
WE textures/off/off3.xpm
EA textures/off/off4.xpm

F 0,0,0
C 0,0,80

111111111111111111111
100000000001000000001
100000000001000000001
1000N0000002000000001
100000000001000000001
111111111111111111111